T,R,R,R,R
R,W,W,W,W
R,R,R,R,R
W,W,W,R,R
E,R,R,R,R