X,R,W,R,R
R,R,W,R,R
W,R,W,R,R
W,R,W,R,R
R,R,R,E,R